g01*P01;g01*P01;g01*P01;g01*___;d01*P01;d01*P01;g01*P01;g01*P01
g01*___;g01*___;d01*___;d01*P01;d01*___;g01*___;g01*___;g01*___
g01*___;g01*___;d01*___;d01*___;d01*___;g01*___;g01*___;g01*___
g01*___;g01*___;g01*___;g01*___;d01*___;g01*___;g01*___;g01*___
d01*___;d01*___;g01*___;g01*___;g01*___;d01*___;g01*___;g01*___
d01*___;d01*___;g01*___;g01*___;g01*___;d01*___;d01*E01;g01*___
d01*___;d01*___;d01*E01;g01*___;g01*E01;g01*___;g01*___;d01*___
g01*E01;g01*E01;g01*___;g01*E01;g01*___;g01*E01;d01*___;d01*E01