g01*____#__;g01*____#__;g01*PA__#__;g01*____#__;d01*PA__#__;d01*PA__#__;g01*PA__#__;g01*____#__
g01*____#__;g01*____#__;d01*____#__;d01*P___#__;d01*____#__;g01*____#__;g01*____#__;g01*____#__
g01*____#__;g01*____#__;d01*____#__;d01*____#__;d01*____#__;g01*____#__;g01*____#__;g01*____#__
g01*____#__;g01*____#__;g01*____#__;g01*____#__;d01*____#__;g01*____#__;g01*____#__;g01*____#__
d01*____#__;d01*____#__;g01*____#__;g01*____#__;g01*____#__;d01*____#__;g01*____#__;g01*____#__
d01*____#__;d01*____#__;g01*____#__;g01*____#__;g01*____#__;d01*____#__;d01*____#__;g01*____#__
d01*____#__;d01*____#__;d01*EA__#__;g01*____#__;g01*EA__#__;g01*____#__;g01*____#__;d01*____#__
g01*EA__#__;g01*EA__#__;g01*____#__;g01*EA__#__;g01*____#__;g01*____#__;d01*____#__;d01*____#__