g01*P01#__;g01*P01#__;g01*P01#__;g01*___#__;d01*P01#__;d01*P01#__;g01*P01#__;g01*P01#__
g01*___#__;g01*___#__;d01*___#__;d01*P01#__;d01*___#__;g01*___#__;g01*___#__;g01*___#__
g01*___#__;g01*___#__;d01*___#__;d01*___#__;d01*___#__;g01*___#__;g01*___#__;g01*___#__
g01*___#__;g01*___#__;g01*___#__;g01*___#__;d01*___#__;g01*___#__;g01*___#__;g01*___#__
d01*___#__;d01*___#__;g01*___#__;g01*___#__;g01*___#__;d01*___#__;g01*___#__;g01*___#__
d01*___#__;d01*___#__;g01*___#__;g01*___#__;g01*___#__;d01*___#__;d01*E01#__;g01*___#__
d01*___#__;d01*___#__;d01*E01#__;g01*___#__;g01*E01#__;g01*___#__;g01*___#__;d01*___#__
g01*E01#__;g01*E01#__;g01#__*___#__;g01*E01#__;g01*___#__;g01*E01#__;d01*___#__;d01*E01#__