g01*P01#01;g01*P01#02;g01*P01#03;g01*___#__;d01*P01#04;d01*P01#05;g01*P01#06;g01*P01#07
g01*___#__;g01*___#__;d01*___#__;d01*P01#08;d01*___#__;g01*___#__;g01*___#__;g01*___#__
g01*___#__;g01*___#__;d01*___#__;d01*___#__;d01*___#__;g01*___#__;g01*___#__;g01*___#__
g01*___#__;g01*___#__;g01*___#__;g01*___#__;d01*___#__;g01*___#__;g01*___#__;g01*___#__
d01*___#__;d01*___#__;g01*___#__;g01*___#__;g01*___#__;d01*___#__;g01*___#__;g01*___#__
d01*___#__;d01*___#__;g01*___#__;g01*___#__;g01*___#__;d01*___#__;d01*E01#03;g01*___#__
d01*___#__;d01*___#__;d01*E01#01;g01*___#__;g01*E01#02;g01*___#__;g01*___#__;d01*___#__
g01*E01#05;g01*E01#07;g01#__*___#__;g01*E01#06;g01*___#__;g01*E01#05;d01*___#__;d01*E01#04