g01*___#__;g01*___#__;g01*P__#__;g01*___#__;d01*P__#__;d01*P__#__;g01*P__#__;g01*___#__
g01*___#__;g01*___#__;d01*___#__;d01*P__#__;d01*___#__;g01*___#__;g01*___#__;g01*___#__
g01*___#__;g01*___#__;d01*___#__;d01*___#__;d01*___#__;g01*___#__;g01*___#__;g01*___#__
g01*___#__;g01*___#__;g01*___#__;g01*___#__;d01*___#__;g01*___#__;g01*___#__;g01*___#__
d01*___#__;d01*___#__;g01*___#__;g01*___#__;g01*___#__;d01*___#__;g01*___#__;g01*___#__
d01*___#__;d01*___#__;g01*___#__;g01*___#__;g01*___#__;d01*___#__;d01*___#__;g01*___#__
d01*___#__;d01*___#__;d01*E__#__;g01*___#__;g01*E__#__;g01*___#__;g01*___#__;d01*___#__
g01*E__#__;g01*E__#__;g01#__*___#__;g01*E__#__;g01*___#__;g01*___#__;d01*___#__;d01*___#__