g01_P01;g01_P01;g01_P01;g01_000;d01_P01;d01_P01;g01_P01;g01_P01
g01_000;g01_000;d01_000;d01_P01;d01_000;g01_000;g01_000;g01_000
g01_000;g01_000;d01_000;d01_000;d01_000;g01_000;g01_000;g01_000
g01_000;g01_000;g01_000;g01_000;d01_000;g01_000;g01_000;g01_000
d01_000;d01_000;g01_000;g01_000;g01_000;d01_000;g01_000;g01_000
d01_000;d01_000;g01_000;g01_000;g01_000;d01_000;d01_000;g01_000
d01_000;d01_000;d01_000;g01_000;g01_000;g01_000;g01_000;d01_000
g01_000;g01_000;g01_000;g01_000;g01_000;g01_000;d01_000;d01_000